NO	   ./textures/text1.xpm
SO      ./textures/text1.xpm
EA		./textures/text2.xpm
WE      ./textures/text2.xpm
F       139,69,19
C       64,64,64

1111111111
1000000001
1000000001
10000000011111111
1000N000000000001
10000000011111111
1000000001
1000000001
1111111111