NO		./textures/text1.xpm
SO		./textures/text1.xpm
EA		./textures/text2.xpm
WE		./textures/text2.xpm

F		107,142,35
C		135,206,250

111111111111111111111111111111111111111111111111111111111111111111111
100000000100000000000000000000000000000000000000001111111110000000001
100000000111111111111111111000000000000000000000000000000000000000001
100000000100000000100000001000000000000000000000000000000000000000001
100000000000010000000000001111111110000000000000000000000000000000001
100000000000000000000000000000000000000000000000000111111111111111111
100000000100000000000000000000000000000000000000000000000000000000001
100000000100000000000000000000000000000000000000000000000000000000001
100000000100000000000000000000000000000000000000001111111110000000001
100000000100000000011111111000000000000000000000000000000000000000001
100000000000000000100000001000000000000000000000000000000000000000001
100000000000010000000000001111111110000000000000000000000000000000001
100000000000010000000000001111111110000000000000000000000000000000001
100000000000010000000000001100000000000000000000000000000000000000001
100000000000010000000000001111101110000000000000000000000000000000001
100000000000010000000000001100001110000000000000000000000000000000001
100000000000010000000000001111100010000000000000000000000000000000001
100000000000010000000000001101110110000000000000000000000000000000001
100000000000010000000000001101110110000000000000000000000000000000001
100000000000010000000000001101110110000000000000000000000000000000001
100000000000010000000000001000000110000000000000000000000000000000001
100000000000010000000000001101111110000000000000000000000000000000001
100000000000010000000000001100001110000000000000000000000000000000001
100000000000010000000000001101101110000000000000000000000000000000001
100000000000010000000000001111101110000000000000N00000000000000000001
100000000000010000000000001111101110000000000000000000000000000000001
100000000000010000000000001100101110000000000000000000000000000000001
100000000000010000000000001110001110000000000000000000000000000000001
100000000000010000000000001110111110000000000000000000000000000000001
100000000000010000000000001110111110000000000000000000000000000000001
100000000000010000000000001110111110000000000000000000000000000000001
100000000000010000000000001110111110000000000000000000000000000000001
100000000000010000000000001000000010000000000000000000000000000000001
100000000000010000000000001000000010000000000000000000000000000000001
100000000000010000000000001000000010000000000000000000000000000000001
100000000000010000000000001000000010000000000000000000000000000000001
100000000000010000000000001000000010000000000000000000000000000000001
100000000000010000000000001000000010000000000000000000000000000000001
100000000000010000000000001000000010000000000000000000000000000000001
100000000000010000000000001000000010000000000000000000000000000000001
100000000000010000000000001000000010000000000000000000000000000000001
100000000000010000000000001000000010000000000000000000000000000000001
100000000000010000000000001000000010000000000000000000000000000000001
100000000000010000000000001000000010000000000000000000000000000000001
111111111111111111111111111111111111111111111111111111111111111111111