1111111111
1000000001
1000000001
1000000001
1000N00001
10000000011111111
10000000000000001
10000000011111111
1111111111