NO		 	textures/text1.xpm
SO		./textures/text1.xpm
EA		./textures/text2.xpm
WE		./textures/text2.xpm

F		107,142,35
C		135,206,250

111111111111111111111111111
1S0000000000000000000000011
10000000000000000000000011
111111111111111110000111111
111111111111111111111111111
111111111111111111111111111
1S0000000000000000000000011
10000000000000000000000011
111111111111111110000111111
111111111111111111111111111
111111111111111111111111111
1S0000000000000000000000011
10000000000000000000000011
111111111111111110000111111
111111111111111111111111111