NO		./textures/text1.xpm
SO		./textures/text1.xpm
EA		./textures/text2.xpm
WE		./textures/text2.xpm
F		139,69,19
C		64,64,64

1111111111                 
1000000001                 
100000000111111111111111111
100000000100000000100000001
1000N0000000010000000000001
100000000111111111111111111
1000000001                 
1000000001                 
1111111111                 